#1#1#1#1#1#1#1#1#1#1#1#1#1#1#1#1#1#1#1#1#1#1#1#1#1#1#1#1#1#1#1#1#1#1#1#1#1#1#1#1#1#1#1#1#1#1#1#1#1#1#1#1#1#1#1#1#1#1#1#1#1#1#1#1#1#1#1#1#1#1#1#1#1#1#1#1#1#1#1#1#1#1#1#1#1#1#1#1#1#1#1#1#1#1#1#1#1
#1#1#1#1#1#1#1#1..#1#1M4#1#1#1#1#1#1#1#1#1#1#1#1#1#1#1#1#1#1#1M5#1#1#1#1#1#1#1#1#1#1#1#1#1#1#1#1#1#1#1#1#1#1#1..........T1T1T1T1T1T1T1T1T1T1#1#1..........#1............#1....................#1#1
#1#1#1#1#1#1........#1..#1..#1#1#1#1#1#1#1#1#1#1#1#1#1#1#1......#1#1#1#1#1#1#1#1#1#1#1#1#1#1#1#1#1#1#1#1#1#1....M2......T1T1T1T1T1T1T1T1T1T1#1#1..S1......#1............#1............S1......#1#1
#1#1#1#1#1..........#1..#1....#1#1#1#1#1#1#1#1#1#1#1#1T1T1T1T1T1T1T1#1#1#1#1#1#1#1#1#1#1#1#1#1#1#1#1#1#1................T1T1T1T1T1T1T1T1T1T1#1#1..............................................#1#1
#1#1................#1M2#1....#1#1#1#1#1#1#1#1#1#1#1#1T1T1T1T1T1T1T1T1#1#1#1#1#1#1#1#1#1#1#1#1#1#1......................T1T1T1T1T1T1T1T1T1T1#1#1#1#1#1#1#1#1............#1#1#1#1#1#1#1#1#1#1#1#1#1
#1....................M1......#1#1#1#1#1#1#1#1#1T1T1T1T1T1T1T1T1T1T1T1#1#1#1#1#1#1#1#1#1#1#1#1#1..........M2............T1T1T1T1T1T1T1T1T1T1#1#1..........#1............#1....................#1#1
#1............................#1#1#1#1#1#1#1#1#1T1T1T1T1T1T1T1T1T1T1T1#1#1#1#1#1#1#1#1#1#1#1#1..........................T1T1T1T1T1T1T1T1T1T1#1#1..S1..................................S1......#1#1
#1....M2......................#1#1#1#1#1#1#1M3........T1T1T1T1T1T1T1T1#1#1#1#1#1#1#1#1#1#1#1............................................T1T1#1#1..........#1............#1....................#1#1
#1..............................#1#1#1#1#1#1..........T1T1T1T1T1T1T1T1#1....#1#1#1#1#1......................................M2..........T1T1#1#1#1#1#1#1#1#1............#1#1#1#1#1#1#1#1#1#1#1#1#1
#1..............................#1#1#1#1..............M1........................#1..............M1............M2......................M2T1T1#1#1..........#1............#1....................#1#1
#1........................M1....#1#1#1#1T1T1T1T1T1M1....................................................................................T1T1#1#1..S1..................................S1......#1#1
#1..............................#1#1#1#1T1T1T1T1T1............................................................T1T1T1T1T1T1T1T1T1T1T1T1..T1T1#1#1..PU..........................................#1#1
#1..............................#1#1#1#1T1T1T1T1T1T1T1T1..........................T1T1T1T1T1T1T1T1T1T1T1T1T1T1T1T1T1T1T1T1T1T1T1T1T1T1T1T1T1#1#1#1#1N1..#1#1............#1#1#1#1#1....#1#1#1#1#1#1
#1M1............................#1#1#1#1T1T1T1M3T1T1T1T1..........................T1T1T1T1T1T1T1T1T1T1T1T1T1T1T1T1T1T1T1T1T1T1T1T1T1T1T1T1T1#1#1..........#1............#1....................#1#1
#1T1T1T1T1T1T1..................#1#1#1T1T1T1T1T1T1T1T1T1T1T1......................T1T1T1T1T1T1T1T1T1T1T1T1T1T1T1T1T1T1T1T1T1T1T1T1T1T1T1T1T1#1#1S1..N1N1..#1............#1S1....#1S1..#1....S1#1#1
#1#2#2#2#2#2T1T1..................................................................T1T1T1T1T1T1T1T1T1T1T1T1T1T1M3T1T1T1T1T1T1T1T1T1T1T1T1T1T1#1#1#1#1#1#1#1#1............#1#1#1#1#1#1#1#1#1#1#1#1#1
#1#2M4..T1T1T1T1..................................................................T1T1T1T1T1T1T1T1T1T1T1T1T1T1T1T1T1T1T1T1T1T1T1T1T1T1T1T1T1#1#1#1#1#1#1#1#1............#1#1#1#1#1#1#1#1#1#1#1#1#1
#1#2#2#2#2#2T1T1..................................................................T1T1T1T1T1T1T1T1T1T1T1T1T1T1T1T1T1T1T1T1T1T1T1T1T1T1T1T1T1T1T1T1T1T1T1T1T1............T1T1T1T1T1T1T1T1T1T1T1T1#1
#1T1T1T1T1T1T1T1..............................................................................M1T1T1T1T1T1T1T1T1T1T1T1T1T1T1....................................................................#1
#1T1....................M1..#1#1#1#1........................................................................T1T1T1T1............................................................................#1
#1T1......................#1#1#1#1#1............................................................................................................................................................#1
#1T1......................#1#1#1#1#1#1..................................................................................................................T1T1T1T1T1T1T1T1T1T1T1T1................#1
#1T1T1......................#1#1#1#1#1#1....................M1..............................................................................T1T1T1T1T1T1T1#1#1#1#1#1#1#1#1#1#1T1T1T1T1T1T1T1T1T1#1
#1T1T1..M1....................#1#1#1#1#1#1..M2........................T1T1T1T1T1T1T1T1T1T1..................................................T1T1T1T1T1T1T1#1#1#1#1#1#1#1#1#1#1T1T1T1T1T1T1T1T1T1#1
#1T1T1....................T1T1T1#1#1#1#1#1#1#1#1#1....................T1T1T1T1T1T1T1T1T1T1................................T1T1T1T1T1T1T1T1T1T1T1T1T1T1T1T1#1#1#1#1#1#1#1#1#1#1..................#1
#1T1T1....................T1T1T1#1#1#1#1#1#1#1#1#1#1..............M1..T1T1T1T1T1T1T1T1T1T1................M1..............T1T1T1T1T1T1T1T1T1#1#1#1#1#1#1#1#1#1#1#1#1#1#1#1#1#1..M2..............#1
#1T1T1....................T1T1T1#1#1#1#1#1#1#1#1#1#1#1T1T1T1T1T1T1T1T1T1T1T1T1T1T1T1T1T1T1T1T1T1T1T1T1T1T1T1T1T1T1T1T1T1T1T1T1T1T1T1T1T1T1T1#1#1#1#1#1#1#1#1#1#1#1#1#1#1#1#1#1..........M2......#1
#1#1T1T1T1................T1T1T1#1#1#1#1#1#1#1#1#1#1#1T1T1T1T1T1T1T1T1T1T1T1T1T1T1T1T1T1T1T1T1T1T1T1T1T1T1T1T1T1T1T1T1T1T1T1T1T1T1T1T1T1T1T1#1#1#1#1#1#1#1#1#1#1#1#1#1#1#1#1#1#1#1#1#1#1#1#1#1#1#1
#1#1#1T1T1T1T1T1T1T1T1T1T1T1T1#1#1#1#1#1#1#1#1#1#1#1#1#1#1#1#1#1#1#1#1#1#1#1#1#1#1#1#1#1#1#1#1#1#1#1#1#1#1#1#1#1#1#1#1#1#1#1#1#1#1#1#1#1#1#1#1#1#1#1#1#1#1#1#1#1#1#1#1#1#1#1#1#1#1#1#1#1#1#1#1#1#1
#1#1#1#1#1T1T1T1T1T1T1T1T1#1#1#1#1#1#1#1#1#1#1#1#1#1#1#1#1#1#1#1#1#1#1#1#1#1#1#1#1#1#1#1#1#1#1#1#1#1#1#1#1#1#1#1#1#1#1#1#1#1#1#1#1#1#1#1#1#1#1#1#1#1#1#1#1#1#1#1#1#1#1#1#1#1#1#1#1#1#1#1#1#1#1#1#1
#1#1#1#1#1#1#1#1#1#1#1#1#1#1#1#1#1#1#1#1#1#1#1#1#1#1#1#1#1#1#1#1#1#1#1#1#1#1#1#1#1#1#1#1#1#1#1#1#1#1#1#1#1#1#1#1#1#1#1#1#1#1#1#1#1#1#1#1#1#1#1#1#1#1#1#1#1#1#1#1#1#1#1#1#1#1#1#1#1#1#1#1#1#1#1#1#1